NO ./img/wolf/NO.xpm
SO ./img/wolf/SO.xpm
WE ./img/wolf/WE.xpm
EA ./img/wolf/EA.xpm

F 248,199,164
C 200,219,223

11111111111
10000000001
10111111101
10100N00001
10111111101
10000000001
11111111111
