NO ./img/wolf/NO.xpm
SO ./img/wolf/SO.xpm
WE ./img/wolf/WE.xpm
EA ./img/wolf/EA.xpm

F 220,100,0
C 225,30,0

11111111111
10000000001
10111111101
10100S00101 
10111111101
10000000001
11111111111
