F 220,100,0
  EA ./img/wolf/EA.xpm
	NO ./img/wolf/NO.xpm
SO                      ./img/wolf/SO.xpm 
 WE   ./img/wolf/WE.xpm                           

C    225,30,0

111111
100101
101001
1100N1
111111
