
NO ./img/wolf/NO.xpm

SO ./img/wolf/SO.xpm

WE ./img/wolf/WE.xpm

EA ./img/wolf/EA.xpm

F 220,100,0

C 225,30,0

111111111111111111111111111111111111111111111111111111111111111111
                       10000000000000001                         1
111111111111111111111111111111101111111111111111111111111111111111
                       10000000N00000001                         1
111111111111111111111111111111101111111111111111111111111111111111
                       10000000000000001                         1
111111111111111111111111111111101111111111111111111111111111111111
                       10000000000000001                         1
111111111111111111111111111111101111111111111111111111111111111111
                       10000000000000001                         1
111111111111111111111111111111101111111111111111111111111111111111
                       10000000000000001                         1
111111111111111111111111111111101111111111111111111111111111111111
                       10000000000000001                         1
111111111111111111111111111111101111111111111111111111111111111111
                       10000000000000001                         1
111111111111111111111111111111101111111111111111111111111111111111
                       10000000000000001                         1
111111111111111111111111111111101111111111111111111111111111111111
                       10000000000000001                         1
111111111111111111111111111111101111111111111111111111111111111111
                       10000000000000001                         1
111111111111111111111111111111101111111111111111111111111111111111
                       10000000000000001                         1
111111111111111111111111111111101111111111111111111111111111111111
                       10000000000000001                         1
111111111111111111111111111111101111111111111111111111111111111111
                       10000000000000001                         1
111111111111111111111111111111101111111111111111111111111111111111
                       10000000000000001                         1
111111111111111111111111111111101111111111111111111111111111111111
                       10000000000000001                         1
111111111111111111111111111111101111111111111111111111111111111111
                       10000000000000001                         1
111111111111111111111111111111101111111111111111111111111111111111
                       10000000000000001                         1
111111111111111111111111111111101111111111111111111111111111111111
                       10000000000000001                         1
111111111111111111111111111111101111111111111111111111111111111111
                       10000000000000001                         1
111111111111111111111111111111101111111111111111111111111111111111
                       10000000000000001                         1
111111111111111111111111111111101111111111111111111111111111111111
                       10000000000000001                         1
111111111111111111111111111111101111111111111111111111111111111111
                       10000000000000001                         1
111111111111111111111111111111101111111111111111111111111111111111
                       10000000000000001                         1
111111111111111111111111111111101111111111111111111111111111111111
                       10000000000000001                         1
111111111111111111111111111111101111111111111111111111111111111111
                       10000000000000001                         1
111111111111111111111111111111101111111111111111111111111111111111
                       10000000000000001                         1
111111111111111111111111111111101111111111111111111111111111111111
                       10000000000000001                         1
111111111111111111111111111111101111111111111111111111111111111111
                       10000000000000001                         1
111111111111111111111111111111101111111111111111111111111111111111
                       10000000000000001                         1
111111111111111111111111111111101111111111111111111111111111111111
                       10000000000000001                         1
111111111111111111111111111111101111111111111111111111111111111111
                       10000000000000001                         1
111111111111111111111111111111101111111111111111111111111111111111
                       10000000000000001                         1
111111111111111111111111111111101111111111111111111111111111111111
                       10000000000000001                         1
111111111111111111111111111111101111111111111111111111111111111111
                       10000000000000001                         1
111111111111111111111111111111101111111111111111111111111111111111
                       10000000000000001                         1
111111111111111111111111111111101111111111111111111111111111111111
                       10000000000000001                         1
111111111111111111111111111111101111111111111111111111111111111111
                       10000000000000001                         1
111111111111111111111111111111101111111111111111111111111111111111
                       10000000000000001                         1
111111111111111111111111111111101111111111111111111111111111111111
                       10000000000000001                         1
111111111111111111111111111111101111111111111111111111111111111111
                       10000000000000001                         1
111111111111111111111111111111101111111111111111111111111111111111
                       10000000000000001                         1
111111111111111111111111111111101111111111111111111111111111111111
                       10000000000000001                         1
111111111111111111111111111111101111111111111111111111111111111111
                       10000000000000001                         1
111111111111111111111111111111101111111111111111111111111111111111
                       10000000000000001                         1
111111111111111111111111111111101111111111111111111111111111111111
                       10000000000000001                         1
111111111111111111111111111111101111111111111111111111111111111111
                       10000000000000001                         1
111111111111111111111111111111101111111111111111111111111111111111
                       10000000000000001                         1
111111111111111111111111111111101111111111111111111111111111111111
                       10000000000000001                         1
111111111111111111111111111111101111111111111111111111111111111111
                       10000000000000001                         1
111111111111111111111111111111101111111111111111111111111111111111
                       10000000000000001                         1
111111111111111111111111111111101111111111111111111111111111111111
                       10000000000000001                         1
111111111111111111111111111111101111111111111111111111111111111111
                       10000000000000001                         1
111111111111111111111111111111101111111111111111111111111111111111
                       10000000000000001                         1
111111111111111111111111111111101111111111111111111111111111111111
                       10000000000000001                         1
111111111111111111111111111111101111111111111111111111111111111111
                       10000000000000001                         1
111111111111111111111111111111101111111111111111111111111111111111
                       10000000000000001                         1
111111111111111111111111111111101111111111111111111111111111111111
                       10000000000000001                         1
111111111111111111111111111111101111111111111111111111111111111111
                       10000000000000001                         1
111111111111111111111111111111101111111111111111111111111111111111
                       10000000000000001                         1
111111111111111111111111111111101111111111111111111111111111111111
                       10000000000000001                         1
111111111111111111111111111111101111111111111111111111111111111111
                       10000000000000001                         1
111111111111111111111111111111101111111111111111111111111111111111
                       10000000000000001                         1
111111111111111111111111111111101111111111111111111111111111111111
                       10000000000000001                         1
111111111111111111111111111111101111111111111111111111111111111111
                       10000000000000001                         1
111111111111111111111111111111101111111111111111111111111111111111
                       10000000000000001                         1
111111111111111111111111111111101111111111111111111111111111111111
                       10000000000000001                         1
111111111111111111111111111111101111111111111111111111111111111111
                       10000000000000001                         1
111111111111111111111111111111101111111111111111111111111111111111
                       10000000000000001                         1
111111111111111111111111111111101111111111111111111111111111111111
                       10000000000000001                         1
111111111111111111111111111111101111111111111111111111111111111111
                       10000000000000001                         1
111111111111111111111111111111101111111111111111111111111111111111
                       10000000000000001                         1
111111111111111111111111111111101111111111111111111111111111111111
                       10000000000000001                         1
111111111111111111111111111111101111111111111111111111111111111111
                       10000000000000001                         1
111111111111111111111111111111101111111111111111111111111111111111
                       10000000000000001                         1
111111111111111111111111111111101111111111111111111111111111111111
                       10000000000000001                         1
111111111111111111111111111111111111111111111111111111111111111111
