
C 225,30,0
NO ./img/wolf/NO.xpm

EA ./img/wolf/EA.xpm
SO ./img/wolf/SO.xpm

WE ./img/wolf/WE.xpm


F 220,100,0


11111111111111111111111111111
11110111111111011100000010001
11110111111111011101010010001
11000000110101011100000010001
10000000000000001100000010001
10000000000000001101010010001
11000001110101011111011110N0111
11110111 1110101 101111010001
11111111 1111111 111111111111

