NO ./img/wolf/NO.xpm
SO ./img/wolf/SO.xpm
WE ./img/wolf/WE.xpm
EA ./img/wolf/EA.xpm

F 248,199,164
C 200,219,223

1111111111111111
1000000000000001
1000000000000001
1000000000000001
1000000000000001
1000000000000001
1000000000000001
10000W0000000001
1000000000000001
1000000000000001
1000000000000001
1000000000000001
1000000000000001
1000000000000001
1111111111111111
