
NO ./img/wolf/NO.xpm

SO ./img/wolf/SO.xpm

WE ./img/wolf/WE.xpm

EA ./img/wolf/EA.xpm

F 220,100,0

C 225,30,0

11011
10001
10N01
10001
11111
