
NO ./img/wolf/NO.xpm

SO ./img/wolf/SO.xpm

EA ./img/wolf/EA.xpm

F 220,100,0

C 225,30,0

111111111
100000N01
111111111